11111
100P1
1C0E1
00000
11111
