1111111111111111
10000000000 0001
1P0011111L110001
10001E0000C10001
1000000000000001
1111111111111111