1111111111
1000000001
1000000001
10C0P00001
1111000001
1E01000001
1111111111
