1111111111111111
1000000000000001
1P00111111110000
10001E0000C10001
1000000000000001
1111111111111111