111111111111111111111111111
1C0000000011C000110C01110C1
100011111111000001000001001
1P001E0000C1C0000C000001001
100000000111001110000000001
10000C000000001000000C00001
1C0000011111111000000000001
111110000110001000111110001
1000C00000C0000000110000C01
111111111111111111111111111
