1111111111111
10000000E0001
1000P00000001
10000000C000111
1111111111111
